90
0
13
5
3
1
1
+P+C+C+C+
PBPBVBPBP
+P+C+C+P+
PBPBPBPBP
+P+P+V+P+
