15
0
1393
39
36
1
1
+P+P+B+P+B+P+P+B+B+P+P+P+B+P+B+P+P+B+B+P+P+B+P+B+P+P+B+B+P+P+P+B+P+B+P+P+B+B+
PBBBPBBBPBPBPBBBPBPBPBBBPBBBPBPBPBBBPBPBBBPBBBPBPBPBBBPBPBPBBBPBBBPBPBPBBBPBP
+P+P+P+P+B+P+P+P+P+P+P+P+P+P+B+P+P+P+P+P+P+P+P+B+P+P+P+P+P+P+P+P+P+B+P+P+P+P+
VBBBPBBBPBPBBBPBBBBBBBBBPBBBPBPBBBPBBBVBBBPBBBPBPBBBPBBBBBBBBBPBBBPBPBBBPBBBV
+P+P+B+B+P+P+B+P+B+B+P+P+B+B+P+P+B+P+B+P+P+B+B+P+P+B+P+B+B+P+P+B+B+P+P+B+P+B+
PBBBBBBBPBBBPBBBPBBBPBBBVBBBPBBBPBBBPBBBBBBBPBBBPBBBPBBBPBBBVBBBPBBBPBBBPBBBB
+P+P+P+B+P+B+B+P+P+P+P+P+P+B+P+B+B+P+P+P+P+P+B+P+B+B+P+P+P+P+P+P+B+P+B+B+P+P+
BBVBBBBBPBPBBBPBBBBBBBBBVBBBPBPBBBPBBBVBVBBBBBPBPBBBPBBBBBBBBBVBBBPBPBBBPBBBV
+P+B+P+B+B+P+B+P+P+P+P+B+P+B+B+P+B+P+P+P+B+P+B+B+P+B+P+P+P+P+B+P+B+B+P+B+P+P+
PBPBBBPBBBPBPBBBPBPBPBPBBBPBBBPBPBBBPBPBPBBBPBBBPBPBBBPBPBPBPBBBPBBBPBPBBBPBP
+P+P+P+B+B+P+P+P+B+P+P+P+P+B+B+P+P+P+B+P+P+P+B+B+P+P+P+B+P+P+P+P+B+B+P+P+P+B+
PBVBBBPBPBBBBBBBBBPBPBBBBBPBPBBBBBBBBBPBVBBBPBPBBBBBBBBBPBPBBBBBPBPBBBBBBBBBP
+P+V+B+P+P+P+P+B+P+B+P+V+B+P+P+P+P+B+P+P+V+B+P+P+P+P+B+P+B+P+V+B+P+P+P+P+B+P+
BBBBPBPBBBPBBBPBBBPBBBBBPBPBBBPBBBPBBBPBBBPBPBBBPBBBPBBBPBBBBBPBPBBBPBBBPBBBP
+P+P+P+P+P+B+P+B+P+P+P+P+P+P+P+B+P+B+P+P+P+P+P+P+B+P+B+P+P+P+P+P+P+P+B+P+B+P+
PBPBBBBBPBBBPBBBPBPBPBPBBBBBPBBBPBBBPBPBPBBBBBPBBBPBBBPBPBPBPBBBBBPBBBPBBBPBP
+B+V+P+P+P+B+B+P+B+P+B+V+P+P+P+B+B+P+B+B+V+P+P+P+B+B+P+B+P+B+V+P+P+P+B+B+P+B+
PBBBBBPBPBBBPBBBPBBBBBPBBBBBBBBBBBPBBBPBBBBBPBPBBBPBBBPBBBBBPBBBBBBBBBBBPBBBP
+P+P+V+P+B+P+P+B+B+P+P+P+B+P+B+P+P+B+B+P+P+V+P+B+P+P+B+B+P+P+P+B+P+B+P+P+B+B+
PBBBPBBBPBPBPBBBPBPBPBBBPBBBPBPBPBBBPBPBBBPBBBPBPBPBBBPBPBPBBBPBBBPBPBPBBBPBP
+P+P+P+P+B+P+P+P+P+P+P+P+P+P+B+P+P+P+P+P+P+P+P+B+P+P+P+P+P+P+P+P+P+B+P+P+P+P+
BBBBPBBBPBPBBBPBBBBBBBBBPBBBPBPBBBPBBBBBPBBBPBPBBBPBBBBBBBBBPBBBPBPBBBPBBBBBB
+P+P+V+B+P+P+B+P+B+B+P+P+B+B+P+P+B+P+B+P+P+V+B+P+P+B+P+B+B+P+P+B+B+P+P+B+P+B+
PBBBBBVBPBBBPBBBPBBBPBBBVBBBPBBBPBBBPBBBBBBBVBPBBBPBBBPBBBPBBBVBBBPBBBPBBBPBB
+P+P+P+B+P+B+B+P+P+P+P+P+P+B+P+B+B+P+P+P+P+P+B+P+B+B+P+P+P+P+P+P+B+P+B+B+P+P+
BBBBVBBBPBPBBBPBBBVBBBBBBBBBPBPBBBPBBBBBBBVBBBPBPBBBPBBBVBBBBBBBBBPBPBBBPBBBB
+P+B+P+B+B+P+B+P+P+P+P+B+P+B+B+P+B+P+P+P+B+P+B+B+P+B+P+P+P+P+B+P+B+B+P+B+P+P+
PBPBBBPBBBPBPBBBPBPBPBPBBBPBBBPBPBBBPBPBPBBBPBBBPBPBBBPBPBPBPBBBPBBBPBPBBBPBP
+P+P+P+B+B+P+P+P+B+P+P+P+P+B+B+P+P+P+B+P+P+P+B+B+P+P+P+B+P+P+P+P+B+B+P+P+P+B+
PBBBBBPBPBBBBBVBBBPBPBBBVBPBPBBBVBBBBBPBBBBBPBPBBBBBVBBBPBPBBBVBPBPBBBVBBBBBP
+P+B+V+P+P+P+P+B+P+B+P+B+B+P+P+P+P+B+P+P+B+V+P+P+P+P+B+P+B+P+B+B+P+P+P+P+B+P+
BBBBPBPBBBPBBBPBBBPBBBBBPBPBBBPBBBPBBBPBBBPBPBBBPBBBPBBBPBBBBBPBPBBBPBBBPBBBP
+P+P+P+P+P+B+P+V+P+P+P+P+P+P+P+B+P+B+P+P+P+P+P+P+B+P+V+P+P+P+P+P+P+P+B+P+B+P+
PBPBBBVBPBBBPBBBPBPBPBPBBBBBPBBBPBBBPBPBPBBBVBPBBBPBBBPBPBPBPBBBBBPBBBPBBBPBP
+B+B+P+P+P+B+B+P+B+P+B+B+P+P+P+B+B+P+B+B+B+P+P+P+B+B+P+B+P+B+B+P+P+P+B+B+P+B+
PBPBBBVBPBBBPBBBPBPBPBPBBBBBPBBBPBBBPBPBPBBBVBPBBBPBBBPBPBPBPBBBBBPBBBPBBBPBP
+P+P+B+P+B+P+P+B+B+P+P+P+B+P+B+P+P+B+B+P+P+B+P+B+P+P+B+B+P+P+P+B+P+B+P+P+B+B+
PBBBPBBBPBPBPBBBPBPBPBBBPBBBPBPBPBBBPBPBBBPBBBPBPBPBBBPBPBPBBBPBBBPBPBPBBBPBP
+P+P+P+P+B+P+P+P+P+P+P+P+P+P+B+P+P+P+P+P+P+P+P+B+P+P+P+P+P+P+P+P+P+B+P+P+P+P+
VBBBPBBBPBPBBBPBBBBBBBBBPBBBPBPBBBPBBBVBBBPBBBPBPBBBPBBBBBBBBBPBBBPBPBBBPBBBV
+P+P+B+B+P+P+B+P+B+B+P+P+B+B+P+P+B+P+B+P+P+B+B+P+P+B+P+B+B+P+P+B+B+P+P+B+P+B+
PBBBBBBBPBBBPBBBPBBBPBBBVBBBPBBBPBBBPBBBBBBBPBBBPBBBPBBBPBBBVBBBPBBBPBBBPBBBB
+P+P+P+B+P+B+B+P+P+P+P+P+P+B+P+B+B+P+P+P+P+P+B+P+B+B+P+P+P+P+P+P+B+P+B+B+P+P+
BBVBBBBBPBPBBBPBBBBBBBBBVBBBPBPBBBPBBBVBVBBBBBPBPBBBPBBBBBBBBBVBBBPBPBBBPBBBV
+P+B+P+B+B+P+B+P+P+P+P+B+P+B+B+P+B+P+P+P+B+P+B+B+P+B+P+P+P+P+B+P+B+B+P+B+P+P+
PBPBBBPBBBPBPBBBPBPBPBPBBBPBBBPBPBBBPBPBPBBBPBBBPBPBBBPBPBPBPBBBPBBBPBPBBBPBP
+P+P+P+B+B+P+P+P+B+P+P+P+P+B+B+P+P+P+B+P+P+P+B+B+P+P+P+B+P+P+P+P+B+B+P+P+P+B+
PBVBBBPBPBBBBBBBBBPBPBBBBBPBPBBBBBBBBBPBVBBBPBPBBBBBBBBBPBPBBBBBPBPBBBBBBBBBP
+P+V+B+P+P+P+P+B+P+B+P+V+B+P+P+P+P+B+P+P+V+B+P+P+P+P+B+P+B+P+V+B+P+P+P+P+B+P+
BBBBPBPBBBPBBBPBBBPBBBBBPBPBBBPBBBPBBBPBBBPBPBBBPBBBPBBBPBBBBBPBPBBBPBBBPBBBP
+P+P+P+P+P+B+P+B+P+P+P+P+P+P+P+B+P+B+P+P+P+P+P+P+B+P+B+P+P+P+P+P+P+P+B+P+B+P+
PBPBBBBBPBBBPBBBPBPBPBPBBBBBPBBBPBBBPBPBPBBBBBPBBBPBBBPBPBPBPBBBBBPBBBPBBBPBP
+B+V+P+P+P+B+B+P+B+P+B+V+P+P+P+B+B+P+B+B+V+P+P+P+B+B+P+B+P+B+V+P+P+P+B+B+P+B+
PBBBBBPBPBBBPBBBPBBBBBPBBBBBBBBBBBPBBBPBBBBBPBPBBBPBBBPBBBBBPBBBBBBBBBBBPBBBP
+P+P+V+P+B+P+P+B+B+P+P+P+B+P+B+P+P+B+B+P+P+V+P+B+P+P+B+B+P+P+P+B+P+B+P+P+B+B+
PBBBPBBBPBPBPBBBPBPBPBBBPBBBPBPBPBBBPBPBBBPBBBPBPBPBBBPBPBPBBBPBBBPBPBPBBBPBP
+P+P+P+P+B+P+P+P+P+P+P+P+P+P+B+P+P+P+P+P+P+P+P+B+P+P+P+P+P+P+P+P+P+B+P+P+P+P+
BBBBPBBBPBPBBBPBBBBBBBBBPBBBPBPBBBPBBBBBPBBBPBPBBBPBBBBBBBBBPBBBPBPBBBPBBBBBB
+P+P+V+B+P+P+B+P+B+B+P+P+B+B+P+P+B+P+B+P+P+V+B+P+P+B+P+B+B+P+P+B+B+P+P+B+P+B+
PBBBBBVBPBBBPBBBPBBBPBBBVBBBPBBBPBBBPBBBBBBBVBPBBBPBBBPBBBPBBBVBBBPBBBPBBBPBB
+P+P+P+B+P+B+B+P+P+P+P+P+P+B+P+B+B+P+P+P+P+P+B+P+B+B+P+P+P+P+P+P+B+P+B+B+P+P+
BBBBVBBBPBPBBBPBBBVBBBBBBBBBPBPBBBPBBBBBBBVBBBPBPBBBPBBBVBBBBBBBBBPBPBBBPBBBB
+P+B+P+B+B+P+B+P+P+P+P+B+P+B+B+P+B+P+P+P+B+P+B+B+P+B+P+P+P+P+B+P+B+B+P+B+P+P+
PBPBBBPBBBPBPBBBPBPBPBPBBBPBBBPBPBBBPBPBPBBBPBBBPBPBBBPBPBPBPBBBPBBBPBPBBBPBP
+P+P+P+B+B+P+P+P+B+P+P+P+P+B+B+P+P+P+B+P+P+P+B+B+P+P+P+B+P+P+P+P+B+B+P+P+P+B+
PBBBBBPBPBBBBBVBBBPBPBBBVBPBPBBBVBBBBBPBBBBBPBPBBBBBVBBBPBPBBBVBPBPBBBVBBBBBP
+P+B+V+P+P+P+P+B+P+B+P+B+B+P+P+P+P+B+P+P+B+V+P+P+P+P+B+P+B+P+B+B+P+P+P+P+B+P+
BBBBPBPBBBPBBBPBBBPBBBBBPBPBBBPBBBPBBBPBBBPBPBBBPBBBPBBBPBBBBBPBPBBBPBBBPBBBP
+P+P+P+P+P+B+P+V+P+P+P+P+P+P+P+B+P+B+P+P+P+P+P+P+B+P+V+P+P+P+P+P+P+P+B+P+B+P+
PBPBBBVBPBBBPBBBPBPBPBPBBBBBPBBBPBBBPBPBPBBBVBPBBBPBBBPBPBPBPBBBBBPBBBPBBBPBP
+B+B+P+P+P+B+B+P+B+P+B+B+P+P+P+B+B+P+B+B+B+P+P+P+B+B+P+B+P+B+B+P+P+P+B+B+P+B+
